############################
#            ..      ..    #
#############      #########
#         ..          ..   #
#    ######   ##############
#   .....       ....       #
##############     #########
#          ....    .       #
############################